1111111111
10000000E1
10000000C1
10000000C1
10000000C1
10000000C1
10000000C1
10000000C1
1X000000P1
1111111111
