1111111111
1000000001
10000000E1
10000ECCC1
10000P0001
11111111E1
