1111111111
111111
1000000001
1111111111
