1111111111111

1111111111001
1111111111E01
111111111C001
1000000000P01
1111111111111
