1111111111
1C000000C1
1000000001
1000000001
100E000001
1000000001
1000000001
1000000001
1P000000C1
1111111111
