111111111
1C00100C1
101010101
1E1010101
111010101
1000101P1
101110101
1000001C1
111111111
