111111111
100000001
101111001
101111CC1
1E1111001
1000000P1
100000111
111111111
