1111111111
1000000001
11100000E1
10000000P1
1000000001
1111111111
