1111111111
1000000001
11100000P1
10000000C1
1000000001
1111111111
