1111111111
1000000001
11100000C1
10000000E1
1000000001
1111111111
